accessibility.force_disabled	1
browser.contentblocking.category	custom
browser.startup.homepage	about:home
browser.tabs.drawInTitlebar	true
browser.urlbar.placeholderName	Google
browser.urlbar.placeholderName.private	Google
gfx.webrender.all	true
gfx.webrender.enabled	true
layers.acceleration.force-enabled	true
media.eme.enabled	true
media.gmp.storage.version.observed	1
network.cookie.cookieBehavior	0
network.predictor.cleaned-up	true
network.security.esni.enabled	true
network.trr.bootstrapAddress	104.16.248.249
network.trr.custom_uri	dns-family.adguard.com
network.trr.mode	3
plugin.disable_full_page_plugin_for_types	application/pdf
privacy.cpd.offlineApps	true
privacy.cpd.siteSettings	true
privacy.sanitize.timeSpan	0
privacy.trackingprotection.cryptomining.enabled	false
privacy.trackingprotection.pbmode.enabled	false
security.disable_button.openCertManager	false
services.sync.declinedEngines	
signon.importedFromSqlite	true
signon.rememberSignons	false
